NO assets/mc_cave.png
NO assets/mc_cave.png
SO assets/mc_house.png
WE assets/mc_desert.png
EA assets/mc_nether.png

F 148,54,0
C 0,132,252

        1111111111111111111111111
        1000000000110000000000001
        1011000001110000000000001
        1001000000000000000000001
111111111011000001110000000000001
100000000011000001110111110111111
11110111111111011100000010001
11110111111111011101010010001
11000000110101011100000010001
10000000000000001100000010001
1000E0000000000011010100100011
11000001110101011111011110001
11110111 1110101 101111010001
11111111 1111111 111111111111