
F 148,54,0
NO ./assets/mc_cave.png
SO ./assets/mc_house.png
WE ./assets/mc_desert.png
EA ./assets/mc_nether.png
C 0A,132,252

11111111111111111111111111111
10000000001100000000000000001
10110000011100000000000000001
100100000000000000000000N0001
11111111100000000000000000001
10000000000000111011111000001
11110111111111011100000010001
11110111111111011101010010001
11000000110101011100000010001
10000000000000001100000010001
10000000000000001101010010001
11000001110101011111011110001
11110111 1110101 101111010001
11111111 1111111 111111111111